00000000000000000000000000000000000000000000100000
00000000000000000000000000000000000000000000100000
00000000000000000000000000000000000000000000100000
00000000000000000000000000000000000000000000100000
00000000000000000000000000000000000000000000100000
00000000000000000000000000000000000000000000800000
00000000000000000000000000000000000000000000100000
00000000000000000000000000000000001191111111100000
00000000000000000000000000000000001000000000000000
00000000000000000000000000000000001000000000000000
00000000000000000000000000000000001000000000000000
00000000000000000000000000000000002000000000000000
00000000000000000000000000000000001000000000000000
00000000000000000000000000000000001000000000000000
00000000000000000000000000000000008000000000000000
00000000000000000000000000000000001000000000000000
00000000000000000000000000000000001000000000000000
00000000000000000000000000000000001000000000000000
00000000000000000000000000000000001000000000000000
00000000000000000000000000000000001000000000000000
00000000000000000000000000111111111000000000000000
00000000000000000000000000144444441000000000000000
00000000000000000000000000144444441000000000000000
11171811111171111131118111111111111000000000000000
00000000000000000000000000000000000000000000000000
00000000000000000000000000000000000000000000000000
00000000000000000000000000000000000000000000000000
00000000000000000000000000000000000000000000000000
00000000000000000000000000000000000000000000000000
00000000000000000000000000000000000000000000000000
