11171111111111111111111111111111111191111111111111
14444444144444444004144444144444144424444444144441
14444444144444444004744444144444144424444444144441
14444444144444444004144444144444144424444444144441
11111111111711111111111111117111111131111111144441
14444444144444440004144444144444444424444444844441
14444444844444440044144444144444444424444444144441
14444444144444400044144444111111111191111111111111
14444444144444400444144444144444441424441444144441
11111111144444000444111711144444441424441444144441
14444444144400004444144444144444441424441444144447
14444444144400000422322222922222222224441444144441
14444444144440000424144444144444441444441444144441
14444444144440000424144444144444441444441444144441
14444444744444400424144444744444448444441444144441
14444444144444400424144444144444441444441444144441
11111111111111111191111111111111111117111111111111
14444444144441400424144444144444441444444444144441
14444444144441400424144444144444441444444444144441
14444444144441400424144444144444441444444444144441
14444444144441400424144444111111111444444444744441
14444444144441400424744444144444441444444444144441
14444444144441400424144444144444441444444444144441
11171811111171111131118111111111111111111111111111
14444444144441004424144444144444441444144444144441
92222222922223222224144444144444441444144444144441
14444444144441000444144444144444441444144444144441
14444444144441400444144444144444441444144444144447
14444444144441400444144444144444441444144444144441
11111111111111111117111111111117111111111111111111
